{
  "width": 20,
  "height": 20,
  "index": 0,
  "maxPlayers": 6,
  "map": [
    [1,1,1,1,1,1,1,1,1,1,1,1,1,1,1,1,1,1,1,1],
    [1,2,0,0,0,0,0,0,0,0,0,0,0,0,0,0,0,2,0,1],
    [1,0,0,1,1,0,0,0,0,0,0,0,0,0,1,1,0,0,0,1],
    [1,0,0,1,0,0,0,0,0,0,0,0,0,0,0,1,0,0,0,1],
    [1,0,0,0,0,0,0,1,0,0,0,0,1,0,0,0,0,0,0,1],
    [1,0,0,0,1,0,0,1,0,0,0,0,1,0,0,1,0,0,0,1],
    [1,0,0,0,1,0,0,0,0,0,0,0,0,0,0,1,0,0,0,1],
    [1,0,0,0,0,0,0,1,1,0,0,1,1,0,0,0,0,0,0,1],
    [1,0,0,0,0,0,0,0,0,0,0,0,0,0,0,0,0,0,0,1],
    [1,2,0,0,0,0,0,0,0,0,0,0,0,0,0,0,0,0,2,1],
    [1,0,0,0,0,0,0,0,1,1,1,1,0,0,0,0,0,0,0,1],
    [1,0,0,0,0,0,0,0,1,0,0,1,0,0,0,0,0,0,0,1],
    [1,0,0,0,0,0,0,0,1,1,1,1,0,0,0,0,0,0,0,1],
    [1,0,0,0,1,0,0,0,0,0,0,0,0,0,1,0,0,0,0,1],
    [1,0,0,0,1,0,0,1,0,0,0,0,1,0,0,1,0,0,0,1],
    [1,0,0,0,0,0,0,1,0,0,0,0,1,0,0,0,0,0,0,1],
    [1,0,0,1,1,0,0,0,0,0,0,0,0,0,1,1,0,0,0,1],
    [1,2,0,0,0,0,0,0,0,0,0,0,0,0,0,0,0,0,2,1],
    [1,0,0,0,0,0,0,0,0,0,0,0,0,0,0,0,0,0,0,1],
    [1,1,1,1,1,1,1,1,1,1,1,1,1,1,1,1,1,1,1,1]
  ]
}